111111111111111111111111111
1E10000000000C0000000000001
1C0001010010000010000000001
1000100101010100001000C0001
1P1000000C00000111111000001
111001001010100C10100000001
101001010010000110000000001
101001010010000010000000001
111111111111111111111111111